111111111111111111111111111
1000000000000000000000P0011
10000000000000C0000000X0001
100000000000E00000000000001
111111111111111111111111111