1111111111111111111111111111111111111111
1P00000000000000000000000000000000000001
1000111111111000111111111111111111000011
1C00000000000000000000000000C00000000001
1111111111111111110011111111111111110011
1E0000000000X000000000000000000000000001
1000111111111111110011111111111111000011
1C00000000000000000000000000C00000000001
1111111111111111110011111111111111110011
1C00000000000000000000000000000000000001
1000111111111111110011111111111111000011
1C0000000000C00000000000000000000X000001
1111111111111111110011111111111111110011
1C00000000000000000000000000C0000X000001
1000111111111111110011111111111111000011
1C00000000000000000000000000000000000001
1111111111111111110011111111111111110011
1C000000000000C0000000000X00000000000001
1111111111111111111111111111111111111111