11111111111111111111111
10000000000111000000011
11000000000C00000001111
100P0000X00000000010001
1000000000000000X000001
100000000000000000000C1
11111111111000000000001
100000C0000000000000X01
10000000000000000001EX1
11111111111111111111111