11111111111111111111111
100C0000000111000C00011
11000000000C00000001111
100P0000100001000010001
10000000000001111000001
10000000C000000000000C1
11111111111000000000001
100000C0100000000000101
10000000000000000001E01
11111111111111111111111