11111111111111111111111
100C0000X00111000C00011
11000000000C000X0001111
100P0000100001000010001
100X0000000001111000001
10000000C000000000000C1
111111111110000000X0001
100X00C0100000000000101
100000000000X0000001E01
11111111111111111111111